25
25
#########################
#...#.........#.........#
###.###.###.#.#.#####.###
#.#...#.#.#.#...#.......#
#.###.#.#.#.#.###.#######
#.....#...#.#.#...#..#..#
s.#########.###.###.###.#
#.........#.#.#.#.......#
#.#######.#.#.#.###.#####
#.......#.#.#.#...#.....#
###.###.#.#.#.###.#####.#
#.#...#.#...#.....#.....#
#.#.#.#.#####.###.#.###.#
#...#.#.....#...#...#.#.#
#####.#.#####.#.#####.#.#
#.....#.#.....#.......#.#
###.###.#.#########.###.#
#...#...#.......#.....#.#
#.###########.###.#.###.#
#.#.....#.#.....#.#.#...#
#.#.#####.#.#####.###.###
#.#.....#.#.....#...#.#.#
#.#####.#.#.#######.#.#.#
#.......#.........#.....#
#######################e#